111111
1P10C1
111101
100001
101E01
111111
