111111
1P10C1
100011
1011E1
111111
