111111
1P10C1
1001
1C0001
101E01
111111
