111111
1P0C01
1C0001
1100C1
1C0E01
111111
