111111
1P10C1
100001
1011E1
1011C1
111111
