111111
1P10C1
10P001
101E01
111111
