111111
1P10C1
10X0E1
101E01
111111
