111111
1P1001
111101
100001
101E11
111111
